0 0 0 0 0 0 0 0 0 0 0 0 0 0 0 0 0 0 0 0 0 0
0 0 0 0 0 0 0 0 0 0 0 0 0 0 0 0 0 0 0 0 0 0
8 0 0 0 0 0 0 0 0 0 0 0 0 0 0 0 0 0 0 0 0 0
8 0 0 0 0 0 0 0 0 0 0 0 0 0 0 0 0 0 0 0 0 0
8 0 0 0 0 0 0 0 0 0 0 0 0 0 0 0 0 0 0 0 0 0
8 1 0 0 0 0 0 0 0 0 0 0 0 0 0 0 0 0 0 8 0 0
8 8 0 0 0 0 0 0 0 0 0 0 0 0 0 0 0 0 0 0 8 0
0 8 0 0 0 0 0 0 0 0 0 0 8 0 0 3 0 0 0 0 0 8
0 8 0 0 0 0 0 0 0 0 0 0 8 3 0 3 3 7 0 0 0 8
0 8 8 8 8 0 0 0 8 8 8 8 8 8 8 8 8 8 8 8 8 8
0 0 0 0 8 0 0 3 8 0 0 0 0 0 0 0 0 0 0 0 0 0
0 0 0 0 8 8 8 8 8 0 0 0 0 0 0 0 0 0 0 0 0 0
