0 0 0 0 0 0 0 0 0 0 0 0 0 0 0 0 0 0
0 0 0 0 0 0 0 0 0 0 0 0 0 0 0 0 0 0
0 0 0 0 0 0 0 0 0 0 0 0 0 0 0 0 0 0
8 0 0 0 0 0 0 0 0 0 0 0 0 0 0 0 0 0
8 0 0 0 0 0 0 0 0 0 0 0 0 0 0 0 0 0
8 0 0 0 0 0 0 0 0 0 0 0 0 0 0 0 0 3
8 0 0 0 0 0 0 0 0 0 0 0 0 0 0 0 3 3
8 0 8 8 8 0 0 0 0 7 0 0 0 8 3 0 8 8
8 0 8 0 8 0 0 0 0 8 0 0 8 8 8 8 8 0
8 0 8 0 8 3 3 0 8 8 0 0 8 0 0 0 0 0
8 1 8 0 8 8 8 8 8 8 0 8 8 0 0 0 0 0
8 8 8 0 8 8 0 0 0 8 8 8 0 0 0 0 0 0
